====================
==S=================
==..================
===.================
===....=============
======.=============
======.=============
======..============
=======.=============
=======.....========
===========.========
===========.========
===========.========
===========.========
===========.========
===========.========
===========.========
===========...======
=============E======
====================
