=S................==
===...............==
===.================
===......===========
========.===========
========.=.......===
========.=.=====.===
========.=.=====.===
========...=====.===
================.===
========.........===
==.......===========
==.==========....===
==.=..........==.===
==...=======.....===
============.=======
============.=======
============.=======
============.======
========E....=======
