==========
S........=
========.=
=......=.=
==.=.=...=
=..=..=.==
=====.==.=
=====....=
=====.==.=
=====E====