=====S..........====
=====..=============
=====.==============
=====.==============
=====.==============
=====..........=====
=====.==============
=====.==============
=====.==============
=====.==============
=====.==============
=.....==============
=====.==============
=====.==============
=====.==.===========
==....==.===========
==.==.==.===========
==.==.==.===========
==.=====.===========
==.............E====
