==========
==S===..==
==..==.===
===.==.===
===....===
======.===
=====..===
===...====
====E=====
==========
