========S===========
========.===========
========.===========
========.===========
========.===========
========.===========
========.===========
========.===========
========.===========
========.===========
========.===========
========.===========
========.===========
========.===========
========.===========
========.===========
========.===========
========.===========
========.===========
========E===========
