==================S=
==================.=
========...........=
========.====.======
========.====.======
====.....====.======
====.========.======
====.==.......======
====.............===
====.===========.===
====.===========.===
====.===========.===
====.===========.===
====.........===.===
================.===
================.===
================.===
================.===
=========........===
=========E==========
