====================
==..................
==.================.
.=.===S........====.
.=.===========.====.
.=.............====.
.==================.
.==.===.=====.=====.
....................
.===================
..............======
=======.============
=======.============
=======.============
=======E============
====================
====================
====================
====================
====================
