==========
===S...===
=====...==
======.===
======.===
=====..===
==.==.====
=====...E=
==========
====...===