=====S====
===...==.=
==.=.=..==
==.=.=..==
====...===
==..==.===
=..===..==
=======..=
========E=
==========