===S...........=====
=========.==========
===.....=.==========
===.===.=.==========
===.......==========
===.================
===.================
===.================
===...............==
=================.==
===========.=====.==
===========.=====.==
===========.=====.==
========..........==
========.==.========
========.==.========
========.==.========
===......===========
===.================
===......E==========
