====================
==S===..============
==..==.=============
===.==.=============
===....=============
======.=============
======.=.===========
=====....===========
=====.==.===========
=====.==.===========
=====.==.===========
=====.==.===========
=====.==.===========
=====.==.===========
=====.==.===========
=====.==.===========
=====..=============
===...==============
====E===============
====================
