==S..........==..===
========.======..===
========.======..===
========.........===
===......=======.===
===.====.=======.===
===.====.........===
===.================
===.================
===...........======
===.=====.===.======
===.=====.===.======
===.=====.===.======
===.=====.===.======
===.=====.===.======
===.=====.===.======
===.=====.===.....==
===.=====.==========
===.================
===......E==========
