====================
==S=================
==..================
===.================
===....=============
======.=============
======.=============
=====..=============
=====.==============
=====.==============
=====.==============
=====.==============
=====.==============
=====.==============
=====.==============
=====.==============
=====.==============
====..==============
====E===============
====================
